1NDDA	--MLIKVKTLT G KEIE ID IEPTDKVERIKERVEEKEG IPPQQQRLIYS GKQM NDEKTAADYKILG GSVLHLVLA
1WM3A	-HINLKVAGQD G SVVQ FK IKRHTPLSKLMKAYCERQG LSMRQIRFRFD GQPI NETDTPAQLEMED EDTIDVFQ-
1YQBA	HLIKVTVKTPK - DKED FS VTDTCTIQQLKEEISQRFK AHPDQLVLIFA GKIL KDPDSLAQCGVRD GLTVHLVIK
2BWFA	MSLNIHIKSG- Q DKWE VN VAPESTVLQFKEAINKANG IPVANQRLIYS GKIL KDDQTVESYHIQD GHSVHLVKS
2FAZA	-SMWIQVRTMD R QTHT VD LSRLTKVEELRRKIQELFH VEPGLQRLFYR GKQM EDGHTLFDYEVRL NDTIQLLVR
2UYZB	EYIKLKVIGQD S SEIH FK VKMTTHLKKLKESYCQRQG VPMNSLRFLFE GQRI ADNHTPKELGMEE EDVIEVYQE
2WYQA	MAVTITLKTLQ Q QTFK IR MEPDETVKVLKEKIEAEKG FPVAGQKLIYA GKIL SDDVPIRDYRIDE KNFVVVMVT
2ZEQA	-GMIVFVRFNS S YGFP VE VDSDTSILQLKEVVAKRQG VPADQLRVIFA GKEL PNHLTVQNCDLEQ QSIVHIVQR
3A4RB	--LRLRVQGKE K QMLE IS LSPDSPLKVLMSHYEEAMG LSGHKLSFFFD GTKL SGKELPADLGLES GDLIEVWG-
3M62B	---SLTFKNFK K EKVP LD LEPSNTILETKTKLAQSIS CEESQIKLIYS GKVL QDSKTVSECGLKD GDQVVFMVS
3PHXB	EPLSILVRNNK G RSST YE VRLTQTVAHLKQQVSGLEG VQDDLFWLTFE GKPL EDQLPLGEYGLKP LSTVFMNLR
3PLUA	HMIEVVVNDRL G KKVR VK CLGEDSVGDFKKVLSLQIG TQPNKIVLQKG GSVL KDHISLEDYEVHD QTNLELYYL
3UF8A	THINLKVSDG- S SEIF FK IKKTTPLRRLMEAFAKRQG KEMDSLRFLYD GIRI QADQTPEDLDMED NDIIEAHR-
3ZDMC	AAVHLTLKKI- K FSIE HD FSPSDTILQIKQHLISEE- SHISEIKLLLK GKVL HDNLFLSDLKVTP NSTITVMIK
4AJYB	MDVFLMIRRH- K TTIF TD AKESSTVFELKRIVEGILK RPPDEQRLYKD DQLL DDGKTLGECGFTS PATVGLAFR
4EEWA	DSLEVLVKTLD S QTRT FI VGAQMNVKEFKEHIAASVS IPSEKQRLIYQ GRVL QDDKKLQEYNVG- GKVIHLVER
4ICVA	QLLTLKIKYPH Q KVLE KQ LPGSMTIQKVKGLLSRLLK VPVSDLLLSYE EIEL NDLKSLQFYSVEN GDCLLVRW-
4PYUA	HMIEVVCNDRL G KKVR VK CNTDDTIGDLKKLIAAQTG TRWNKIVLKKW YTIF KDHVSLGDYEIHD GMNLELYYQ
4X57B	ESIDIKFRLYD G SDIG FR YSAASTVDFLKQRVVSDW- KGINEVKLISS GKIL ENNKTVGQCK--- VIVMHVVVQ
5CHWF	EPLSILVRNER G HSNI YE VFLTQTVDTLKKKVSQREQ VHEDQFWLSFE GRPM EDKELLGEYGLKP QCTVIKHLR
5DK8B	-HHQIFVKTLT G KTIT LE VEPSDTIENVKAKIQDKEG IPPDQQRLIFA GKQL EDGRTLSDYNIQK ESTLHLVLR
5JP1B	VHINLKVKGQD G NEVF FR IKRSTQMRKLMNAYCDRQS VDMNSIAFLFD GRRL RAEQTPDELEMEE GDEIDAMLH
